XXXXXXXXXXXXXXXXXXXXXXXXXXXXXXXXXXXXXXXXXXXXXXXXXXXXXXXXXXXXGGGGXXXXXXXXXXXXXXXXXXXXXXXXXXXXXXXXXXXXXXXXXXXXXXXXXXXXXXXXXXXXXXXXXXXXXXXXXXXXXXX
XXXXXXXXXXXXXXXXXXXXXXXXXXXXXXXXXXXXXXXXXXXXXXXXXXXXXXXXXXXXTTTTXXXXXXXXXXXXXXXXXXXXXXXXXXXXXXXXXXXXXXXXXXXXXXXXXXXXXXXXXXXXXXXXXXXXXXXXXXXXXXX
XXXXXXXXXXXGGGGXXXXXXXXXXXXXXXXXXXGGXXXXXXXXXXXXXXXXXXXXXXXXTTTTXXXXXXXXXXXXXXXXXXXGGXXXXXXXXXXXXXXGGGXXXXXXXXXXXXXXXXXXXXXXXXXXXXXXXXXXXXXXXXX
XXXGGGXXXXXTTTTXXXXXXXXXGGXXXXXXXXTTXXXXXXXXXXXXXXXXGGGXXXXXTTTTXXXXXXXXXGGXXXXXXXXTTXXXXXXXXXXXXXXTTTXXXXXXXXXXXXXXXXXXXXXXXXXXXXXXXXXXXXXXXXX
GGGTTTGGGGGTTTTGGGGGGGGGTTGGGGGGGGTTGGGGGGGGGGGGGGGGTTTGGGGGTTTTGGGGGGGGGTTGGGGGGGGTTGGGGGGGGGGGGGGTTTGGGGGGGGGGGGGGGGGGGGGGGGGGGGGGGGGGGGGGGGG
TTTTTTTTTTTTTTTTTTTTTTTTTTTTTTTTTTTTTTTTTTTTTTTTTTTTTTTTTTTTTTTTTTTTTTTTTTTTTTTTTTTTTTTTTTTTTTTTTTTTTTTTTTTTTTTTTTTTTTTTTTTTTTTTTTTTTTTTTTTTTTT
TTTTTTTTTTTTTTTTTTTTTTTTTTTTTTTTTTTTTTTTTTTTTTTTTTTTTTTTTTTTTTTTTTTTTTTTTTTTTTTTTTTTTTTTTTTTTTTTTTTTTTTTTTTTTTTTTTTTTTTTTTTTTTTTTTTTTTTTTTTTTTT